111111111111111111111
10C0000000000000000P1
100011111111111111111
1R0000000000000000001
111111111110011111111
100000000C100111R00C1
1R0111111110011111001
100000000000000000001
111111100111111111111
1000C1000100000000001
1000R1000100001111001
100000000000001E00001
111111111111111111111