1111111111111111111111111111111111
1E100000000C111000000C000000000001
1010011110101R10111001111100010101
10100RRR101010100C1001C00000010101
1010000010101C1000100100000001R101
1010000010101010001001000000010101
1010010C10101010001001RRR000010101
1010011110101010001001RRR000010101
1P0000000C10C0000000010000000C1RC1
1111111111111111111111111111111111