11111111
100000E1
10111111
1C000001
11111101
100000C1
10111111
101111C1
1C000001
11100111
10000001
10111101
1C0000C1
11100111
1P000001
11111111